Year,Round,PTS,OPTS,Diff,Seed,School,OpponentSeed,Opponent
2021,First Round,73,62,11,11,UCLA,6 ,BYU
2021,First Round,62,58,4,13,Ohio,4 ,Virginia
2021,First Round,63,54,9,10,Maryland,7 ,UConn
2021,First Round,53,52,1,14,Abilene Christian,3 ,Texas
2021,First Round,85,62,23,9 ,Wisconsin,8 ,UNC
2021,First Round,78,62,16,11,Syracuse,6 ,San Diego State
2021,First Round,60,56,4,10,Rutgers,7 ,Clemson
2021,First Round,70,56,14,12,Oregon State,5 ,Tennessee
2021,First Round,75,72,3,15,Oral Roberts,2 ,Ohio State
2021,First Round,78,69,9,13,North Texas,4 ,Purdue
2019,First Round,78,61,17,9 ,Washington,8 ,Utah State
2019,First Round,72,54,18,12,Oregon,5 ,Wisconsin
2019,First Round,95,72,23,9 ,Oklahoma,8 ,Ole Miss
2019,First Round,62,59,3,11,Ohio State,6 ,Iowa State
2019,First Round,80,76,4,12,Liberty,5 ,Mississippi State
2019,First Round,79,72,7,10,Iowa,7 ,Cincinnati
2019,First Round,73,58,15,9 ,UCF,8 ,VCU
2019,First Round,70,64,6,13,UC-Irvine,4 ,Kansas State
2019,First Round,83,64,19,12,Murray State,5 ,Marquette
2019,First Round,86,76,10,10,Minnesota,7 ,Louisville
2019,First Round,70,61,9,10,Florida,7 ,Nevada
2019,First Round,78,69,9,9 ,Baylor,8 ,Syracuse
2018,First Round,57,52,5,11,Syracuse,6 ,TCU
2018,First Round,74,54,20,16,UMBC,1 ,Virginia
2018,First Round,81,75,6,13,Marshall,4 ,Wichita State
2018,First Round,69,59,10,9 ,Kansas State,8 ,Creighton
2018,First Round,67,54,13,9 ,Florida State,8 ,Missouri
2018,First Round,79,62,17,10,Butler,7 ,Arkansas
2018,First Round,64,62,2,11,Loyola (IL),6 ,Miami (FL)
2018,First Round,89,68,21,13,Buffalo,4 ,Arizona
2018,First Round,86,83,3,9 ,Alabama,8 ,Virginia Tech
2017,First Round,64,58,6,10,Wichita State,7 ,Dayton
2017,First Round,66,65,1,11,USC,6 ,SMU
2017,First Round,84,72,12,11,Rhode Island,6 ,Creighton
2017,First Round,78,58,20,9 ,Michigan State,8 ,Miami (FL)
2017,First Round,76,65,11,11,Xavier,6 ,Maryland
2017,First Round,81,72,9,12,Middle Tennessee State,5 ,Minnesota
2016,First Round,75,67,8,10, VCU,7 ,Oregon State
2016,First Round,70,51,19,10,Syracuse,7 ,Dayton
2016,First Round,70,56,14,14,Stephen F. Austin,3 ,West Virginia
2016,First Round,75,72,3,11,Northern Iowa,6 ,Texas
2016,First Round,90,81,9,15,Middle Tennessee State,2 ,Michigan State
2016,First Round,77,66,11,13,Hawaii,4 ,California
2016,First Round,79,75,4,12,Yale,5 ,Baylor
2016,First Round,65,55,10,11,Wichita State,6 ,Arizona
2016,First Round,70,69,1,9 ,Providence,8 ,USC
2016,First Round,68,52,16,11,Gonzaga,6 ,Seton Hall
2016,First Round,74,67,7,9 ,UConn,8 ,Colorado
2016,First Round,71,61,10,9 ,Butler,8 ,Texas Tech
2016,First Round,85,83,2,12,Little Rock,5 ,Purdue
2015,First Round,66,53,13,11,Dayton,6 ,Providence
2015,First Round,60,59,1,11,UCLA,6 ,SMU
2015,First Round,75,72,3,10,Ohio State,7 ,VCU
2015,First Round,57,56,1,14,Georgia State,3 ,Baylor
2015,First Round,60,59,1,14,Alabama-Birmingham,3 ,Iowa State
2014,First Round,86,67,19,11,Tennessee,6 ,UMass
2014,First Round,77,75,2,12,Stephen F. Austin,5 ,VCU
2014,First Round,58,53,5,10,Stanford,7 ,New Mexico
2014,First Round,78,71,7,14,Mercer,3 ,Duke
2014,First Round,77,48,29,9 ,Pitt,8 ,Colorado
2014,First Round,80,75,5,12,North Dakota State,5 ,Oklahoma
2014,First Round,61,57,4,12,Harvard,5 ,Cincinnati
2014,First Round,60,59,1,11,Dayton,6 ,Ohio State
2013,First Round,76,72,4,9 ,Temple,8 ,NC State
2013,First Round,57,46,11,12,Ole Miss,5 ,Wisconsin
2013,First Round,83,63,20,11,Minnesota,6 ,UCLA
2013,First Round,63,61,2,13,La Salle,4 ,Kansas State
2013,First Round,76,58,18,10,Iowa State,7 ,Notre Dame
2013,First Round,78,68,10,15,Florida Gulf Coast,2 ,Georgetown
2013,First Round,73,55,18,9 ,Wichita State,8 ,Pitt
2013,First Round,68,55,13,12,Oregon,5 ,Oklahoma State
2013,First Round,68,62,6,14,Harvard,3 ,New Mexico
2013,First Round,64,61,3,12,California,5 ,UNLV
2012,First Round,67,63,4,10,Xavier,7 ,Notre Dame
2012,First Round,58,44,14,12,South Florida,5 ,Temple
2012,First Round,61,54,7,9 ,Saint Louis,8 ,Memphis
2012,First Round,72,69,3,10,Purdue,7 ,Saint Mary's
2012,First Round,65,60,5,13,Ohio,4 ,Michigan
2012,First Round,79,65,14,11,NC State,6 ,San Diego State
2012,First Round,86,84,2,15,Norfolk State,2 ,Missouri
2012,First Round,75,70,5,15,Lehigh,2 ,Duke
2012,First Round,62,59,3,12,VCU,5 ,Wichita State
2012,First Round,68,64,4,11,Colorado,6 ,UNLV
2011,First Round,74,56,18,11,VCU,6 ,Georgetown
2011,First Round,66,55,11,11,Marquette,6 ,Xavier
2011,First Round,73,62,11,9 ,Illinois,8 ,UNLV
2011,First Round,57,50,7,10,Florida State,7 ,Texas A&M
2011,First Round,69,66,3,12,Richmond,5 ,Vanderbilt
2011,First Round,62,61,1,13,Morehead State,4 ,Louisville
2011,First Round,86,71,15,11,Gonzaga,6 ,St. John's (NY)
2010,First Round,86,78,8,10,Missouri,7 ,Clemson
2010,First Round,64,59,5,10,Georgia Tech,7 ,Oklahoma State
2010,First Round,78,65,13,12,Cornell,5 ,Temple
2010,First Round,80,78,2,11,Washington,6 ,Marquette
2010,First Round,81,80,1,9 ,Wake Forest,8 ,Texas
2010,First Round,80,71,9,10,Saint Mary's,7 ,Richmond
2010,First Round,51,50,1,11,Old Dominion,6 ,Notre Dame
2010,First Round,97,83,14,14,Ohio,3 ,Georgetown
2010,First Round,69,66,3,9 ,Northern Iowa,8 ,UNLV
2010,First Round,66,65,1,13,Murray State,4 ,Vanderbilt
2009,First Round,84,71,13,12,Arizona,5 ,Utah
2009,First Round,84,69,15,13,Cleveland State,4 ,Wake Forest
2009,First Round,68,60,8,11,Dayton,6 ,West Virginia
2009,First Round,72,55,17,10,USC,7 ,Boston College
2009,First Round,61,59,2,12,Wisconsin,5 ,Florida State
2009,First Round,74,72,2,9 ,Siena,8 ,Ohio State
2009,First Round,79,66,13,9 ,Texas A&M,8 ,BYU
2009,First Round,84,71,13,10,Maryland,7 ,California
2009,First Round,62,59,3,10,Michigan,7 ,Clemson
2009,First Round,76,72,4,12,Western Kentucky,5 ,Illinois
2008,First Round,75,69,6,12,Villanova,5 ,Clemson
2008,First Round,86,72,14,9 ,Arkansas,8 ,Indiana
2008,First Round,70,69,1,13,San Diego,4 ,UConn
2008,First Round,82,76,6,10,Davidson,7 ,Gonzaga
2008,First Round,101,99,2,12,Western Kentucky,5 ,Drake
2008,First Round,83,62,21,13,Siena,4 ,Vanderbilt
2008,First Round,67,62,5,9 ,Texas A&M,8 ,BYU
2008,First Round,80,67,13,11,Kansas State,6 ,USC
2007,First Round,74,64,10,11,Winthrop,6 ,Notre Dame
2007,First Round,72,63,9,9 ,Purdue,8 ,Arizona
2007,First Round,79,77,2,9 ,Xavier,8 ,BYU
2007,First Round,79,77,2,11,VCU,6 ,Duke
2007,First Round,61,49,12,9 ,Michigan State,8 ,Marquette
2006,First Round,77,73,4,13,Bradley,4 ,Kansas
2006,First Round,59,55,4,9 ,Bucknell,8 ,Arkansas
2006,First Round,75,65,10,11,George Mason,6 ,Michigan State
2006,First Round,58,52,6,10,NC State,7 ,California
2006,First Round,64,63,1,14,Northwestern State,3 ,Iowa
2006,First Round,90,85,5,10,Alabama,7 ,Marquette
2006,First Round,66,58,8,12,Texas A&M,5 ,Syracuse
2006,First Round,82,74,8,11,Milwaukee,6 ,Oklahoma
2006,First Round,87,79,8,12,Montana,5 ,Nevada
2005,First Round,64,63,1,14,Bucknell,3 ,Kansas
2005,First Round,60,57,3,13,Vermont,4 ,Syracuse
2005,First Round,64,53,11,9 ,Iowa State,8 ,Minnesota
2005,First Round,93,70,23,9 ,Mississippi State,8 ,Stanford
2005,First Round,75,63,12,10,NC State,7 ,Charlotte
2005,First Round,82,68,14,11,11 Alabama-Birmingham,6 ,LSU
2005,First Round,83,73,10,12,Milwaukee,5 ,Alabama
2005,First Round,61,57,4,9 ,Nevada,8 ,Texas
2004,First Round,102,100,2,9 ,Alabama-Birmingham,8 ,Washington
2004,First Round,66,58,8,12,Pacific,5 ,Providence
2004,First Round,75,60,15,12,Manhattan,5 ,Florida
2004,First Round,72,66,6,10,Nevada,7 ,Michigan State
2003,First Round,65,63,2,10,Auburn,7 ,St. Joseph's
2003,First Round,47,46,1,12,Butler,5 ,Mississippi State
2003,First Round,60,58,2,9 ,Utah,8 ,Oregon
2003,First Round,80,56,24,9 ,Purdue,8 ,LSU
2003,First Round,84,71,13,10,Arizona State,7 ,Memphis
2003,First Round,79,73,6,11,Central Michigan,6 ,Creighton
2003,First Round,74,69,5,9 ,Gonzaga,8 ,Cincinnati
2003,First Round,84,71,13,13,Tulsa,4 ,Dayton
2002,First Round,83,82,1,12,Creighton,5 ,Florida
2002,First Round,76,68,8,11,Southern Illinois,6 ,Texas Tech
2002,First Round,69,61,8,10,Kent State,7 ,Oklahoma State
2002,First Round,93,80,13,12,Missouri,5 ,Miami (FL)
2002,First Round,73,66,7,11,Wyoming,6 ,Gonzaga
2002,First Round,71,69,2,12,Tulsa,5 ,Marquette
2002,First Round,93,89,4,13,UNC Wilmington,4 ,USC
2001,First Round,79,65,14,11,Temple,6 ,Texas
2001,First Round,79,63,16,10,Butler,7 ,Wake Forest
2001,First Round,70,63,7,9 ,Charlotte,8 ,Tennessee
2001,First Round,82,70,12,9 ,Fresno State,8 ,California
2001,First Round,86,85,1,12,Gonzaga,5 ,Virginia
2001,First Round,70,68,2,13,Indiana State,4 ,Oklahoma
2001,First Round,63,61,2,10,Georgetown,7 ,Arkansas
2001,First Round,50,49,1,11,Georgia State,6 ,Wisconsin
2001,First Round,58,57,1,15,Hampton,2 ,Iowa State
2001,First Round,77,68,9,12,Utah State,5 ,Ohio State
2001,First Round,77,73,4,13,Kent State,4 ,Indiana
2001,First Round,66,62,4,9 ,St. Joseph's,8 ,Georgia Tech
2001,First Round,70,68,2,9 ,Missouri,8 ,Georgia
2000,First Round,72,71,1,10,Seton Hall,7 ,Oregon
2000,First Round,77,57,20,11,Pepperdine,6 ,Indiana
2000,First Round,77,66,11,10,Gonzaga,7 ,Louisville
1999,First Round,62,53,9,9 ,Tulsa,8 ,College of Charleston
1999,First Round,59,58,1,10,Miami (OH),7 ,Washington
1999,First Round,72,70,2,9 ,Ole Miss,8 ,Villanova
1999,First Round,43,32,11,12,Missouri State,5 ,Wisconsin
1999,First Round,61,60,1,13,Oklahoma,4 ,Arizona
1999,First Round,58,54,4,10,Purdue,7 ,Texas
1999,First Round,62,58,4,10,Creighton,7 ,Louisville
1999,First Round,76,74,2,14,Weber State,3 ,UNC
1999,First Round,56,53,3,12,Detroit,5 ,UCLA
1999,First Round,75,63,12,10,Gonzaga,7 ,Minnesota
1999,First Round,61,59,2,9 ,New Mexico,8 ,Missouri
1999,First Round,69,61,8,9 ,Oklahoma State,8 ,Syracuse
1998,First Round,51,46,5,10,Saint Louis,7 ,UMass
1998,First Round,66,64,2,10,Detroit,7 ,St. John's (NY)
1998,First Round,96,87,9,12,Florida State,5 ,TCU
1998,First Round,70,69,1,13,Valparaiso,4 ,Ole Miss
1998,First Round,75,72,3,11,Western Michigan,6 ,Clemson
1998,First Round,62,61,1,14,Richmond,3 ,South Carolina
1998,First Round,69,68,1,11,Washington,6 ,Xavier
1998,First Round,82,81,1,9 ,Illinois State,8 ,Tennessee
1998,First Round,82,52,30,10,West Virginia,7 ,Temple
1997,First Round,71,58,13,10,Texas,7 ,Wisconsin
1997,First Round,62,40,22,9 ,Temple,8 ,Ole Miss
1997,First Round,73,70,3,14,Chattanooga,3 ,Georgia
1997,First Round,78,65,13,15,Coppin State,2 ,South Carolina
1997,First Round,71,58,13,10,Texas,7,Wisconsin
1997,First Round,75,66,9,12,College of Charleston,5,Maryland
1997,First Round,80,62,18,9 ,Colorado,8,Indiana
1996,First Round,64,51,13,11,Boston College,6,Indiana
1996,First Round,91,79,12,10,Santa Clara,7,Maryland
1996,First Round,80,76,4,10,Texas,7,Michigan
1996,First Round,86,80,6,12,Arkansas,5,Penn State
1996,First Round,75,63,12,12,Drexel,5,Memphis
1996,First Round,75,60,15,9 ,Eastern Michigan,8,Duke
1996,First Round,43,41,2,13,Princeton,4,UCLA
1996,First Round,66,58,8,9 ,Stanford,8,Bradley
1996,First Round,61,48,13,9 ,Virginia Tech,8,Green Bay
1995,First Round,89,81,8,14,Old Dominion,3,Villanova
1995,First Round,70,68,2,10,Stanford,7,Charlotte
1995,First Round,79,72,7,14,Weber State,3,Michigan State
1995,First Round,77,67,10,13,Manhattan,4,Oklahoma
1995,First Round,71,62,9,12,Miami (OH),5,Arizona
1995,First Round,64,61,3,9 ,Saint Louis,8,Minnesota
1995,First Round,90,73,17,11,Texas,6,Oregon
1995,First Round,76,70,6,9 ,Tulane,8,BYU
1994,First Round,67,64,3,9 ,Boston College,8,Washington State
1994,First Round,84,77,7,9 ,Georgetown,8,Illinois
1994,First Round,112,102,10,12,Tulsa,5,UCLA
1994,First Round,76,70,6,9 ,Alabama,8,Providence
1994,First Round,51,46,5,10,George Washington,7,Alabama-Birmingham
1994,First Round,61,57,4,12,Green Bay,5,California
1994,First Round,74,66,8,10,Maryland,7,Saint Louis
1994,First Round,90,80,10,11,Penn,6,Nebraska
1994,First Round,80,72,8,9 ,Wisconsin,8,Cincinnati
1993,First Round,82,68,14,12,George Washington,5,New Mexico
1993,First Round,93,78,15,13,Southern,4,Georgia Tech
1993,First Round,81,70,11,9 ,UCLA,8,Iowa State
1993,First Round,73,55,18,9 ,Xavier,8,New Orleans
1993,First Round,64,61,3,15,Santa Clara,2,Arizona
1993,First Round,55,53,2,11,Tulane,6,Kansas State
1992,First Round,87,80,7,14,ETSU,3,Arizona
1992,First Round,76,74,2,10,Iowa State,7,Charlotte
1992,First Round,87,83,4,13,Louisiana,4,Oklahoma
1992,First Round,81,73,8,12,New Mexico State,5,DePaul
1992,First Round,55,50,5,9 ,UTEP,8,Evansville
1992,First Round,61,57,4,10,Tulane,7,St. John's (NY)
1992,First Round,86,65,21,9 ,UConn,8,Nebraska
1992,First Round,98,92,6,9 ,Iowa,8,Texas
1991,First Round,76,56,20,12,Eastern Michigan,5,Mississippi State
1991,First Round,74,69,5,13,Penn State,4,UCLA
1991,First Round,50,48,2,9 ,Villanova,8,Princeton
1991,First Round,61,48,13,10,BYU,7,Virginia
1991,First Round,79,62,17,11,UConn,6,LSU
1991,First Round,64,56,8,11,Creighton,6,New Mexico State
1991,First Round,73,69,4,15,Richmond,2,Syracuse
1991,First Round,80,63,17,10,Temple,7,Purdue
1991,First Round,89,84,5,14,Xavier,3,Nebraska
1990,First Round,111,92,19,11,Loyola Marymount,6,New Mexico State
1990,First Round,74,71,3,14,Northern Iowa,3,Missouri
1990,First Round,100,88,12,10,Texas,7,Georgia
1990,First Round,54,53,1,12,Ball State,5,Oregon State
1990,First Round,65,63,2,9 ,California,8,Indiana
1990,First Round,70,66,4,9 ,UCSB,8,Houston
1990,First Round,88,86,2,12,Dayton,5,Illinois
1989,First Round,68,46,22,10,Colorado State,7,Florida
1989,First Round,94,90,4,11,Evansville,6,Oregon State
1989,First Round,81,65,16,9 ,Notre Dame,8,Vanderbilt
1989,First Round,86,84,2,11,South Alabama,6,Alabama
1989,First Round,76,70,6,11,Texas,6,Georgia Tech
1989,First Round,68,64,4,9 ,Ball State,8,Pitt
1989,First Round,83,70,13,9 ,Clemson,8,Saint Mary's
1989,First Round,66,63,3,12,DePaul,5,Memphis
1989,First Round,83,74,9,9 ,Louisiana Tech,8,La Salle
1989,First Round,97,83,14,13,Middle Tennessee,4,Florida State
1989,First Round,86,75,11,11,Minnesota,6,Kansas State
1989,First Round,80,78,2,14,Siena,3,Stanford
1988,First Round,78,75,3,14,Murray State,3,NC State
1988,First Round,72,69,3,13,Richmond,4,Indiana
1988,First Round,119,115,4,10,Loyola Marymount,7,Wyoming
1988,First Round,75,60,15,9 ,Memphis,8,Baylor
1988,First Round,87,80,7,11,Rhode Island,6,Missouri
1987,First Round,85,79,6,10,LSU,7,Georgia Tech
1987,First Round,65,60,5,13,Missouri State,4,Clemson
1987,First Round,91,77,14,9 ,Ohio State,8,Kentucky
1987,First Round,64,62,2,10,Western Kentucky,7,West Virginia
1987,First Round,68,67,1,14,Austin Peay,3,Illinois
1987,First Round,82,79,3,9 ,Kansas State,8,Georgia
1987,First Round,97,82,15,9 ,Michigan,8,Navy
1987,First Round,64,60,4,12,Wyoming,5,Virginia
1987,First Round,70,69,1,13,Xavier,4,Missouri
1986,First Round,90,83,7,14,Little Rock,3,Notre Dame
1986,First Round,83,79,4,14,Cleveland State,3,Indiana
1986,First Round,72,68,4,12,DePaul,5,Virginia
1986,First Round,94,87,7,11,LSU,6,Purdue
1986,First Round,61,50,11,9 ,Temple,8,Jacksonville
1986,First Round,71,62,9,10,Villanova,7,Virginia Tech
1985,First Round,55,53,2,11,Boston College,6,Texas Tech
1985,First Round,78,55,23,13,Navy,4,LSU
1985,First Round,79,75,4,11,UTEP,6,Tulsa
1985,First Round,63,54,9,9 ,Arkansas,8,Iowa
1985,First Round,59,58,1,11,Auburn,6,Purdue
1985,First Round,58,55,3,9 ,Illinois State,8,USC
1985,First Round,66,58,8,12,Kentucky,5,Washington