Year,Round,PTS,OPTS,Diff,Seed,School,OpponentSeed,Opponent
2021,Second Round,81,78,3,15,Oral Roberts,7,Florida
2013,Second Round,76,74,2,13,La Salle,12,Ole Miss
2013,Second Round,81,71,10,15,Florida Gulf Coast,7,San Diego State
2012,Second Round,62,56,6,13,Ohio,12,South Florida
2006,Second Round,72,66,6,13,Bradley,5,Pitt
1999,Second Round,85,72,13,13,Oklahoma,5,Charlotte
1998,Second Round,83,77,6,13,Valparaiso,12,Florida State
1997,Second Round,75,63,12,14,Chattanooga,6,Illinois
1988,Second Round,59,55,4,13,Richmond,5,Georgia Tech
1986,Second Round,75,69,6,14,Cleveland State,6,St. Joseph's
2021,Second Round,80,70,10,12,Oregon State,4,Oklahoma State
2013,Second Round,74,57,17,12,Oregon,4,Saint Louis
2010,Second Round,87,69,18,12,Cornell,4,Wisconsin
2005,Second Round,83,75,8,12,Milwaukee,4,Boston College
2003,Second Round,79,71,8,12,Butler,4,Louisville
2002,Second Round,83,67,16,12,Missouri,4,Ohio State
1999,Second Round,81,51,30,12,Missouri State,4,Tennessee
1996,Second Round,65,56,9,12,Arkansas,4,Marquette
1994,Second Round,82,80,2,12,Tulsa,4,Oklahoma State
1990,Second Round,62,60,2,12,Ball State,4,Louisville
1987,Second Round,78,68,10,12,Wyoming,4,UCLA
1986,Second Round,74,69,5,12,DePaul,4,Oklahoma
1985,Second Round,64,61,3,12,Kentucky,4,UNLV
2021,Second Round,75,72,3,11,Syracuse,3,West Virginia
2018,Second Round,55,53,2,11,Syracuse,3,Michigan State
2018,Second Round,63,62,1,11,Loyola (IL),3,Tennessee
2017,Second Round,91,66,25,11,Xavier,3,Florida State
2016,Second Round,82,59,23,11,Gonzaga,3,Utah
2014,Second Round,55,53,2,11,Dayton,3,Syracuse
2012,Second Round,66,63,3,11,NC State,3,Georgetown
2011,Second Round,66,62,4,11,Marquette,3,Syracuse
2011,Second Round,94,76,18,11,VCU,3,Purdue
2010,Second Round,82,64,18,11,Washington,3,New Mexico
2006,Second Round,65,60,5,11,George Mason,3,UNC
2002,Second Round,77,75,2,11,Southern Illinois,3,Georgia
2001,Second Round,75,54,21,11,Temple,3,Florida
1990,Second Round,149,115,34,11,Loyola Marymount,3,Michigan
1988,Second Round,97,94,3,11,Rhode Island,3,Syracuse
1986,Second Round,83,81,2,11,LSU,3,Memphis
1985,Second Round,74,73,1,11,Boston College,3,Duke
1985,Second Round,66,64,2,11,Auburn,3,Kansas
2014,Second Round,60,57,3,10,Stanford,2,Kansas
2011,Second Round,71,57,14,10,Florida State,2,Notre Dame
2010,Second Round,75,68,7,10,Saint Mary's,2,Villanova
2008,Second Round,74,70,4,10,Davidson,2,Georgetown
2005,Second Round,65,62,3,10,NC State,2,UConn
2004,Second Round,91,72,19,10,Nevada,2,Gonzaga
2003,Second Round,68,62,6,10,Auburn,2,Wake Forest
2002,Second Round,71,58,13,10,Kent State,2,Alabama
2000,Second Round,67,65,2,10,Seton Hall,2,Temple
2000,Second Round,82,76,6,10,Gonzaga,2,St. John's (NY)
1999,Second Round,73,63,10,10,Purdue,2,Miami (FL)
1999,Second Round,66,58,8,10,Miami (OH),2,Utah
1999,Second Round,82,74,8,10,Gonzaga,2,Stanford
1998,Second Round,75,74,1,10,West Virginia,2,Cincinnati
1997,Second Round,98,87,11,10,Providence,2,Duke
1994,Second Round,95,87,8,10,Maryland,2,UMass
1990,Second Round,73,72,1,10,Texas,2,Purdue
1987,Second Round,72,62,10,10,LSU,2,Temple
2018,Second Round,75,70,5,9,Florida State,1,Xavier
2013,Second Round,76,70,6,9,Wichita State,1,Gonzaga
2010,Second Round,69,67,2,9,Northern Iowa,1,Kansas
2004,Second Round,76,75,1,9,Alabama-Birmingham,1,Kentucky
1994,Second Round,75,72,3,9,Boston College,1,UNC
1992,Second Round,66,60,6,9,UTEP,1,Kansas
2021,Second Round,71,58,13,8,Loyola (IL),1,Illinois
2017,Second Round,65,62,3,8,Wisconsin,1,Villanova
2015,Second Round,71,68,3,8,NC State,1,Villanova
2014,Second Round,78,76,2,8,Kentucky,1,Wichita State
2011,Second Round,71,70,1,8,Butler,1,Pitt
2004,Second Round,70,67,3,8,Alabama,1,Stanford
2002,Second Round,105,101,4,8,UCLA,1,Cincinnati
2000,Second Round,60,53,7,8,UNC,1,Stanford
2000,Second Round,66,59,7,8,Wisconsin,1,Arizona
1998,Second Round,80,75,5,8,Rhode Island,1,Kansas
1996,Second Round,76,69,7,8,Georgia,1,Purdue
1990,Second Round,79,77,2,8,UNC,1,Oklahoma
1986,Second Round,81,65,16,8,Auburn,1,St. John's (NY)
1985,Second Round,59,55,4,8,Villanova,1,Michigan
2021,Second Round,95,80,15,7,Oregon,2,Iowa
2018,Second Round,86,65,21,7,Texas A&M,2,UNC
2018,Second Round,75,73,2,7,Nevada,2,Cincinnati
2017,Second Round,88,81,7,7,South Carolina,2,Duke
2017,Second Round,73,69,4,7,Michigan,2,Louisville
2016,Second Round,66,63,3,7,Wisconsin,2,Xavier
2015,Second Round,78,65,13,7,Wichita State,2,Kansas
2015,Second Round,60,54,6,7,Michigan State,2,Virginia
2014,Second Round,77,65,12,7,UConn,2,Villanova
2008,Second Round,73,67,6,7,West Virginia,2,Duke
2007,Second Round,74,68,6,7,UNLV,2,Wisconsin
2006,Second Round,70,52,18,7,Georgetown,2,Ohio State
2006,Second Round,80,73,7,7,Wichita State,2,Tennessee
2005,Second Round,111,105,6,7,West Virginia,2,Wake Forest
2004,Second Round,89,74,15,7,Xavier,2,Mississippi State
2003,Second Round,68,46,22,7,Michigan State,2,Florida
2001,Second Round,82,74,8,7,Penn State,2,UNC
2000,Second Round,69,61,8,7,Tulsa,2,Cincinnati
1993,Second Round,72,68,4,7,Western Kentucky,2,Seton Hall
1992,Second Round,79,78,1,7,Georgia Tech,2,USC
1990,Second Round,71,70,1,7,UCLA,2,Kansas
1990,Second Round,77,55,22,7,Alabama,2,Arizona
1988,Second Round,80,74,6,7,Vanderbilt,2,Pitt
1986,Second Round,97,85,12,7,Navy,2,Syracuse
1986,Second Round,72,69,3,7,Iowa State,2,Michigan
1985,Second Round,63,59,4,7,Alabama,2,VCU
2021,Second Round,85,51,34,6,USC,3,Kansas
2014,Second Round,85,55,30,6,Baylor,3,Creighton
2012,Second Round,62,56,6,6,Cincinnati,3,Florida State
2010,Second Round,71,68,3,6,Xavier,3,Pitt
2007,Second Round,78,74,4,6,Vanderbilt,3,Washington State
2005,Second Round,67,58,9,6,Utah,3,Oklahoma
2005,Second Round,71,69,2,6,Texas Tech,3,Gonzaga
2004,Second Round,75,73,2,6,Vanderbilt,3,NC State
2003,Second Round,77,64,13,6,Maryland,3,Xavier
2002,Second Round,68,64,4,6,Texas,3,Mississippi State
2001,Second Round,74,71,3,6,USC,3,Boston College
2000,Second Round,75,62,13,6,Miami (FL),3,Ohio State
2000,Second Round,105,70,35,6,UCLA,3,Maryland
2000,Second Round,66,62,4,6,Purdue,3,Oklahoma
1999,Second Round,64,54,10,6,Temple,3,Cincinnati
1998,Second Round,85,82,3,6,UCLA,3,Michigan
1997,Second Round,72,66,6,6,Stanford,3,Wake Forest
1997,Second Round,64,63,1,6,Louisville,3,New Mexico
1997,Second Round,67,66,1,6,Iowa State,3,Cincinnati
1996,Second Round,68,64,4,6,Louisville,3,Villanova
1995,Second Round,75,73,2,6,Memphis,3,Purdue
1994,Second Round,75,63,12,6,Marquette,3,Kentucky
1993,Second Round,71,56,15,6,Virginia,3,UMass
1993,Second Round,82,77,5,6,California,3,Duke
1992,Second Round,82,80,2,6,Memphis,3,Arkansas
1990,Second Round,74,71,3,6,Xavier,3,Georgetown
1988,Second Round,66,63,3,6,Villanova,3,Illinois
1987,Second Round,85,66,19,6,Florida,3,Purdue
1987,Second Round,96,93,3,6,Oklahoma,3,Pitt
2019,Second Round,89,75,14,5,Auburn,4,Kansas
2018,Second Round,84,53,31,5,Clemson,4,Auburn
2016,Second Round,73,67,6,5,Indiana,4,Kentucky
2015,Second Round,69,59,10,5,West Virginia,4,Maryland
2015,Second Round,75,64,11,5,Utah,4,Georgetown
2011,Second Round,70,69,1,5,Arizona,4,Texas
2010,Second Round,85,83,2,5,Michigan State,4,Maryland
2009,Second Round,76,74,2,5,Purdue,4,Washington
2008,Second Round,65,54,11,5,Michigan State,4,Pitt
2007,Second Round,77,74,3,5,Tennessee,4,Virginia
2007,Second Round,87,68,19,5,USC,4,Texas
2007,Second Round,62,59,3,5,Butler,4,Maryland
2006,Second Round,67,64,3,5,Washington,4,Illinois
2005,Second Round,76,65,11,5,Villanova,4,Florida
2004,Second Round,92,68,24,5,Illinois,4,Cincinnati
2004,Second Round,72,70,2,5,Syracuse,4,Maryland
2003,Second Round,68,60,8,5,Notre Dame,4,Illinois
2003,Second Round,85,74,11,5,UConn,4,Stanford
2000,Second Round,93,76,17,5,Florida,4,Illinois
1999,Second Round,82,72,10,5,Iowa,4,Arkansas
1998,Second Round,56,46,10,5,Syracuse,4,New Mexico
1997,Second Round,75,68,7,5,California,4,Villanova
1995,Second Round,78,64,14,5,Mississippi State,4,Utah
1994,Second Round,67,58,9,5,Indiana,4,Temple
1993,Second Round,84,78,6,5,Wake Forest,4,Iowa
1990,Second Round,79,75,4,5,Clemson,4,La Salle
1989,Second Round,102,96,6,5,NC State,4,Iowa
1988,Second Round,104,86,18,5,Iowa,4,UNLV
1988,Second Round,97,76,21,5,Louisville,4,BYU
1987,Second Round,58,57,1,5,Notre Dame,4,TCU
1986,Second Round,58,56,2,5,Alabama,4,Illinois
1986,Second Round,80,68,12,5,Michigan State,4,Georgetown
1985,Second Round,79,67,12,5,Louisiana Tech,4,Ohio State